11111111111111111111111
1111111111100000CCCCCC1
1P00000000E00000CCCCCC1
1111111111100000CCCCCC1
11111111111111111111111