1111111111
1P1CCCCCC1
111000E001
1111111111