1111111111
1P1CCCCCC1
1000000001
100000E001
1111111111