111111111
100C00001
10000C101
110000011
1P00000E1
111111111