11111111111111111
1P100000000000001
10100000000000001
1000000CC00000001
1E0C0000000000001
10000000000000001
11111111111111111