11111111111111111111
1P00000000110001CCC1
10000000001100010011
10000000001100000001
1000000000110000E001
11111111111111111111